#######################################
#### West European Cultural Setting ###
#######################################

### Germanic ###
AUS = "countries/WestEuropean.txt" # Austria /
HOL = "countries/WestEuropean.txt" # Netherlands / 
GER = "countries/WestEuropean.txt" # Germany / 
RHI = "countries/WestEuropean.txt" # Rhineland / 
LUX = "countries/WestEuropean.txt" # Luxembourg / 
SHO = "countries/WestEuropean.txt" # Schleswig-Holstein /
FLA = "countries/WestEuropean.txt" # Flanders / 
EGL = "countries/WestEuropean.txt" # England /
NGM = "countries/WestEuropean.txt" # North Germany /
PRS = "countries/WestEuropean.txt" # Prussia / 
SGM = "countries/WestEuropean.txt" # South Germany /

### Latin ###
FRA = "countries/WestEuropean.txt" # France / 
POR = "countries/WestEuropean.txt" # Portugal / 
ROM = "countries/EastEuropean.txt" # Romania / 
SPA = "countries/WestEuropean.txt" # Spain / 
ITA = "countries/WestEuropean.txt" # Italy / 
GAL = "countries/WestEuropean.txt" # Galicia / 
MOL = "countries/WestEuropean.txt" # Moldova /
LOM = "countries/WestEuropean.txt" # Lombardy /
PIE = "countries/WestEuropean.txt" # Piedmont / 
SAR = "countries/WestEuropean.txt" # Sardinia / 
STE = "countries/WestEuropean.txt" # Papal State
TRA = "countries/WestEuropean.txt" # Transylvania /
VNE = "countries/WestEuropean.txt" # Venice / 
WLL = "countries/WestEuropean.txt" # Wallonia / 

### Scandinavian ###
DEN = "countries/WestEuropean.txt" # Denmark / 
NOR = "countries/WestEuropean.txt" # Norway / 
SWE = "countries/WestEuropean.txt" # Sweden / 
ICE = "countries/WestEuropean.txt" # Iceland / 

### Various ###
BEL = "countries/WestEuropean.txt" # Belgium /
BRI = "countries/WestEuropean.txt" # Brittany /
ENG = "countries/WestEuropean.txt" # United Kingdom / 
HUN = "countries/WestEuropean.txt" # Hungary / 
IRE = "countries/WestEuropean.txt" # Ireland / 
SWI = "countries/WestEuropean.txt" # Switzerland /
FIN = "countries/WestEuropean.txt" # Finland /  
BSQ = "countries/WestEuropean.txt" # Basque /
CTL = "countries/WestEuropean.txt" # Catalonia /
MLT = "countries/WestEuropean.txt" # Malta / 
SCO = "countries/WestEuropean.txt" # Scotland/ 
WLS = "countries/WestEuropean.txt" # Wales /

########################################
#### East European Cultural Setting ####
########################################

### Baltic ###
LAT = "countries/EastEuropean.txt" # Latvia / 
LIT = "countries/EastEuropean.txt" # Lithuania /
EST = "countries/EastEuropean.txt" # Estonia / 

### Slavic ###
BLR = "countries/EastEuropean.txt" # Belarus / 
BUL = "countries/EastEuropean.txt" # Bulgaria /
CZE = "countries/EastEuropean.txt" # Czechoslovakia / 
POL = "countries/EastEuropean.txt" # Poland / 
RUS = "countries/EastEuropean.txt" # Russian Republic / 
SLO = "countries/EastEuropean.txt" # Slovakia / 
SOV = "countries/EastEuropean.txt" # Soviet Union /
UKR = "countries/EastEuropean.txt" # Ukraine / 
YUG = "countries/EastEuropean.txt" # Yugoslavia / 
BOS = "countries/EastEuropean.txt" # Bosnia-Herzegovina / 
CRO = "countries/EastEuropean.txt" # Croatia /
MAC = "countries/EastEuropean.txt" # Macedonia / 
MNE = "countries/EastEuropean.txt" # Montenegro / 
SER = "countries/EastEuropean.txt" # Serbia /
SLV = "countries/EastEuropean.txt" # Slovenia /

### Various ###
ALB = "countries/EastEuropean.txt" # Albania /
GRE = "countries/EastEuropean.txt" # Greece / 
DAG = "countries/EastEuropean.txt" # Dagestan /
GEO = "countries/EastEuropean.txt" # Georgia /
CYP = "countries/MiddleEastern.txt" # Cyprus / 
ARM = "countries/MiddleEastern.txt" # Armenia / 
AZR = "countries/MiddleEastern.txt" # Azerbaijan /

#########################################
#### North American Cultural Setting ####
#########################################

### British Commonwealth ###
CAN = "countries/Commonwealth.txt" # Canada / 
NFL = "countries/Commonwealth.txt" # Newfoundland / 

### the States ###
USA = "countries/WestEuropean.txt" # United States /
CLB = "countries/WestEuropean.txt" # Columbia /
CLF = "countries/WestEuropean.txt" # California / 
NAR = "countries/WestEuropean.txt" # New America /
NEE = "countries/WestEuropean.txt" # New England /
QUE = "countries/WestEuropean.txt" # Quebec /
SCA = "countries/WestEuropean.txt" # Socialist America / 
SNE = "countries/WestEuropean.txt" # Shoshone / 
TEX = "countries/WestEuropean.txt" # Texas / 

#########################################
#### South American Cultural Setting ####
#########################################

### South America ###
ARG = "countries/SouthAmerican.txt" # Argentina
BOL = "countries/SouthAmerican.txt" # Bolivia
BRA = "countries/SouthAmerican.txt" # Brazil
CHL = "countries/SouthAmerican.txt" # Chile
COL = "countries/SouthAmerican.txt" # Colombia
COS = "countries/SouthAmerican.txt" # Costa Rica
CUB = "countries/SouthAmerican.txt" # Cuba
DOM = "countries/SouthAmerican.txt" # Dominican Republic
ECU = "countries/SouthAmerican.txt" # Ecuador
ELS = "countries/SouthAmerican.txt" # El Salvador
GUA = "countries/SouthAmerican.txt" # Guatemala
HAI = "countries/SouthAmerican.txt" # Haiti
HON = "countries/SouthAmerican.txt" # Honduras
MEX = "countries/SouthAmerican.txt" # Mexico
NIC = "countries/SouthAmerican.txt" # Nicaragua
PAN = "countries/SouthAmerican.txt" # Panama
PAR = "countries/SouthAmerican.txt" # Paraguay
PRU = "countries/SouthAmerican.txt" # Peru
URG = "countries/SouthAmerican.txt" # Uruguay
VEN = "countries/SouthAmerican.txt" # Venezuela
CRU = "countries/SouthAmerican.txt" # Cruzoob
JAM = "countries/SouthAmerican.txt" # Jamaica
PUE = "countries/SouthAmerican.txt" # Puerto Rico
SUR = "countries/SouthAmerican.txt" # Suriname
TRI = "countries/SouthAmerican.txt" # Trinidad and Tobago
GYA = "countries/SouthAmerican.txt" # Guyana

###############################
#### Asian Cultural Setting ###
###############################

### Middle East - Central Asia ###
KAZ = "countries/MiddleEastern.txt" # Kazakhstan /
KYR = "countries/MiddleEastern.txt" # Kyrgyzstan / 
TMS = "countries/MiddleEastern.txt" # Turkmenistan / 
UZB = "countries/MiddleEastern.txt" # Uzbekistan /
TAJ = "countries/MiddleEastern.txt" # Tajikistan / 

### Middle East - Arab Sphere ###
AFG = "countries/MiddleEastern.txt" # Afghanistan /
HEJ = "countries/MiddleEastern.txt" # Hashemite Arabia /
IRQ = "countries/MiddleEastern.txt" # Iraq / 
ISC = "countries/MiddleEastern.txt" # Straits Commission /
KUR = "countries/MiddleEastern.txt" # Kurdistan / 
OMA = "countries/MiddleEastern.txt" # Oman / 
MUS = "countries/MiddleEastern.txt" # Muscat / 
PAL = "countries/MiddleEastern.txt" # Palestine /
PER = "countries/MiddleEastern.txt" # Persia / 
SYR = "countries/MiddleEastern.txt" # Syria / 
TUR = "countries/MiddleEastern.txt" # Turkey / 
YEM = "countries/MiddleEastern.txt" # Yemen / 
BAH = "countries/MiddleEastern.txt" # Bahrain /
RAS = "countries/MiddleEastern.txt" # Rashidi Arabia / 
LEB = "countries/MiddleEastern.txt" # Lebanon / 
ISR = "countries/MiddleEastern.txt" # Israel / 
JOR = "countries/MiddleEastern.txt" # Jordan / 
KUW = "countries/MiddleEastern.txt" # Kuwait / 
QAR = "countries/MiddleEastern.txt" # Qatar /
SAU = "countries/MiddleEastern.txt" # Saudi Arabia / 
TRU = "countries/MiddleEastern.txt" # Trucial States / 
MHR = "countries/MiddleEastern.txt" # Mohammerah /

### Far East ###
TNJ = "countries/Asian.txt" # Tianjin /
CHI = "countries/Asian.txt" # Kuomintang/Nanjing Regime /
FNG = "countries/Asian.txt" # Fengtian/Beijing Regime /
JAP = "countries/Asian.txt" # Japan /
KML = "countries/Asian.txt" # Kumul Khanate / 
MEN = "countries/Asian.txt" # Inner Mongolia /
MON = "countries/Asian.txt" # Mongolia /
PHI = "countries/Asian.txt" # Philippines /
SCH = "countries/Asian.txt" # Sichuan /
SDL = "countries/Asian.txt" # Shandong /
SHX = "countries/Asian.txt" # Shanxi / 
SIA = "countries/Asian.txt" # Siam / 
SIK = "countries/Asian.txt" # Xinjiang /
TIB = "countries/Asian.txt" # Tibet /
XSM = "countries/Asian.txt" # Ma Clique /
YUN = "countries/Asian.txt" # Yunnan /
ZHI = "countries/Asian.txt" # Zhili /
BRM = "countries/Asian.txt" # Burma /
CAM = "countries/Asian.txt" # Cambodia /
CHB = "countries/Asian.txt" # Chuanbian/Xikang Clique /
ETK = "countries/Asian.txt" # East Turkestan / 
HNN = "countries/Asian.txt" # Hunan /
GXC = "countries/Asian.txt" # Guangxi / 
MAN = "countries/Asian.txt" # Manchuria /
INC = "countries/Asian.txt" # Indochina /
INS = "countries/Asian.txt" # Insulindia /
KCH = "countries/Asian.txt" # Kachin /
KOR = "countries/Asian.txt" # Korea / 
LAO = "countries/Asian.txt" # Laos /
SRW = "countries/Asian.txt" # Sarawak /
MAL = "countries/Asian.txt" # Malaysia /
SHN = "countries/Asian.txt" # Shan /
TAI = "countries/Asian.txt" # Taiwan /
VIN = "countries/Asian.txt" # Vietnam / 

### India ###
RAJ = "countries/Commonwealth.txt" # British Raj
ASM = "countries/Indian.txt" # Assam / 
BAL = "countries/Indian.txt" # Baluchistan / 
BNG = "countries/Indian.txt" # Bengal / 
CEY = "countries/Indian.txt" # Sri Lanka /
GUJ = "countries/Indian.txt" # Gujarat /
HYD = "countries/Indian.txt" # Hyderabad / 
IND = "countries/Indian.txt" # India / 
KAS = "countries/Indian.txt" # Kashmir / 
MDR = "countries/Indian.txt" # Madras / 
MLD = "countries/Indian.txt" # Maldives /
MYS = "countries/Indian.txt" # Mysore / 
ORI = "countries/Indian.txt" # Orissa / 
PAK = "countries/Indian.txt" # Pakistan / 
PUN = "countries/Indian.txt" # Punjab / 
RJH = "countries/Indian.txt" # Rajahstan / 
TRV = "countries/Indian.txt" # Travancore /

### Various ###
BHU = "countries/Asian.txt" # Bhutan / 
NEP = "countries/Asian.txt" # Nepal / 
DRS = "countries/Asian.txt" # Sikkim/Dremoshong /
DEI = "countries/WestEuropean.txt" # Dutch East Indies / 
SIB = "countries/EastEuropean.txt" # Siberia /
BEI = "countries/Commonwealth.txt" # British East Indies / 
FIC = "countries/FrenchColony.txt" # French Indochina /

##################################
#### African Cultural Setting ####
##################################

### North Africa ###
LBA = "countries/MiddleEastern.txt" # Libya /
TUN = "countries/MiddleEastern.txt" # Tunisia / 
ALG = "countries/MiddleEastern.txt" # Algeria /
EGY = "countries/MiddleEastern.txt" # Egypt / 
MOR = "countries/MiddleEastern.txt" # Morocco / 

### West Africa ###
NGA = "countries/African.txt" # Nigeria / 
ADA = "countries/African.txt" # Kel Adagh /
AIR = "countries/African.txt" # Kel Air  / 
HAU = "countries/African.txt" # Hausaland /
MRT = "countries/African.txt" # Mauritania / 
MSL = "countries/African.txt" # Mossiland / 
MLI = "countries/African.txt" # Mali / 
LIB = "countries/African.txt" # Liberia /
BOR = "countries/African.txt" # Bornu /  
CHA = "countries/African.txt" # Chad / 
DAH = "countries/African.txt" # Dahomey /
GAM = "countries/African.txt" # Gambia / 
GHA = "countries/African.txt" # Ghana / 
GNA = "countries/African.txt" # Guinea /
SIE = "countries/African.txt" # Sierra Leone / 
IVO = "countries/African.txt" # Ivory Coast / 
TOG = "countries/African.txt" # Togo /
YOR = "countries/African.txt" # Yoruba /
NGR = "countries/African.txt" # Niger /
SEN = "countries/African.txt" # Senegal / 

### Central Africa ###
COG = "countries/African.txt" # Congo / Belgian Congo 
CMR = "countries/African.txt" # Cameroon / 
ANG = "countries/African.txt" # Angola / 
GAB = "countries/African.txt" # Gabon / 
OBG = "countries/African.txt" # Oubangui-Chari /

### East Africa ###
AFR = "countries/African.txt" # Afra, Aussa /
ETH = "countries/African.txt" # Ethiopia / 
ERI = "countries/African.txt" # Eritrea / 
SOM = "countries/African.txt" # Somalia / 
SUD = "countries/African.txt" # Sudan / 
KEN = "countries/African.txt" # Kenya / 
BGA = "countries/African.txt" # Buganda / 
BRD = "countries/African.txt" # Burundi / 
RWA = "countries/African.txt" # Rwanda / 
TGN = "countries/African.txt" # Tanganyika / 
UGA = "countries/African.txt" # Uganda /
ZAN = "countries/African.txt" # Zanzibar / 

### South Africa ###
BOT = "countries/African.txt" # Botswana / 
BSL = "countries/African.txt" # Barotseland / 
LES = "countries/African.txt" # Lesotho /
MAD = "countries/African.txt" # Madagascar /
MLW = "countries/African.txt" # Nyasaland /
MZB = "countries/African.txt" # Mozambique /
NMB = "countries/African.txt" # Namibia /
SWA = "countries/African.txt" # Swaziland /
ZAM = "countries/African.txt" # Zambia / 
ZIM = "countries/African.txt" # Zimbabwe / 

### Various ###
EQA = "countries/FrenchColony.txt" # French Equatorial Africa / 
WEA = "countries/FrenchColony.txt" # French West Africa / 
RHO = "countries/Commonwealth.txt" # United Rhodesia / 
SAF = "countries/Commonwealth.txt" # South Africa / 

### Oceania ###
AST = "countries/Commonwealth.txt" # Australia
NZL = "countries/Commonwealth.txt" # New Zealand
PNG = "countries/Commonwealth.txt" # Papua New Guinea
FIJ = "countries/Commonwealth.txt" # Fiji
SSF = "countries/Commonwealth.txt" # South Seas Federation
HAW = "countries/WestEuropean.txt" # Hawaii

### Others
XXB = "countries/WestEuropean.txt" # Archive of the World